NBA	体育
CBA	体育
足球	体育
篮球	体育
欧冠	体育
德甲	体育
英超	体育
冠军欧洲	体育
中国之星	真人秀 音乐
动物世界	生活
大丈夫	家庭 现代都市
花千骨	古装 神话魔幻
音乐风云榜	音乐
军事纪实	军事
一仆二主	现代都市
军事报道	军事
动画片	动画片
第一动画乐园	动画片
普法栏目剧	法制
勇敢的心	革命
奔跑吧兄弟	 真人秀
都市房产报道	科教
超级访问	现代都市
笑傲江湖	武侠 古装
天气预报	生活
综艺喜乐汇	综艺
天下父母	情感
寂寞空庭春欲晚	古装 爱情
傻儿传奇	喜剧
加油吧实习生	现代都市 爱情
刀客家族的女人	历史传奇
剑侠传奇	神话魔幻 武侠 古装
玄奘之路	纪录片
薛平贵与王宝钏	古装 爱情
王牌对王牌	游戏 真人秀 内地
红高粱	家庭 战争 乡村
法治时空	法制
天网	法制
新萧十一郎	武侠 古装
观点致胜	脱口秀
军旅人生	军事
人与健康	生活
打狗棍	历史传奇 战争
晚间新闻	新闻
法律讲堂	法制
二胎时代	现代都市
夜线	情感
非常静距离	内地 娱乐 访谈
吉尼斯中国之夜	综艺
有一说一	新闻 脱口秀
琅琊榜	武侠 古装
防务新观察	新闻
爱情保卫战	情感
直播全球	新闻
中国成语大会	科教 综艺
光荣绽放	综艺
精彩音乐汇	音乐
知音人间	情感
热线12	法制
二十四小时	游戏 真人秀 内地
爱情回来了	现代都市 爱情
技行天下	真人秀
影视留声机	音乐
江苏新时空	新闻
天津新闻	新闻
幸福请你等等我	现代都市 家庭
新闻眼	新闻
冰雪奇迹	综艺
战长沙	革命
陆军一号	军旅
非你莫属	真人秀
财经壹资讯	财经
还是夫妻	现代都市 爱情 家庭
开门大吉	音乐 综艺
食尚大转盘	生活
天天有喜之人间有爱	神话魔幻 古装
新闻联播	新闻
西游记	神话魔幻 古装 动作
夜栈	电影
CCTV家庭幽默大赛	综艺
人与自然	科教
非常故事汇	脱口秀
农业气象	生活
12点报道	新闻
幸福来敲门	家庭
卡通乐园	少儿
舌尖上的中国	纪录片
现场说法	法制
聚焦三农	新闻
传奇中国	纪录片
新视界	科教
X档案	科教
越战越勇	综艺
箭在弦上	革命 战争
记者再报告	新闻
天天有喜	神话魔幻 古装
回声嘹亮	综艺
黄金100秒	综艺
星光大道	综艺
焦点访谈	法制
武媚娘传奇	历史传奇 古装 爱情
校园好声音	真人秀
广东新闻联播	新闻
讲武堂	军事
幸福账单	生活
幽默观察家	综艺
金牌调解	生活 情感
燃烧吧少年	 真人秀
朝闻天下	新闻
唐伯虎点秋香	 爱恋 经典 口碑佳片
今日说法	法制
综艺盛典	综艺
致富经	财经
你会怎么做	情感
车天下	生活
天作之合	综艺
谢谢你来了	真人秀 综艺
农广天地	财经
新闻深一度	新闻
平安365	生活
青丘狐传说	神话魔幻 古装
快乐大本营	真人秀 脱口秀 搞笑
乡村法制剧场	 纪实
微视频大赛	综艺
快乐生活一点通	生活
杨澜访谈录	访谈
我爱满堂彩	综艺
旋风孝子	真人秀
军事科技	军事
娱乐梦工厂	综艺
美丽中国乡村行	生活
最强大脑	真人秀 益智 内地
娱乐星天地	综艺
旋风少女	爱情 青春偶像
北平无战事	革命 战争
西游奇遇记	 真人秀 旅游 内地
每日农经	财经 生活
爸爸在海外	真人秀
闯关东	纪录片
百战经典	军事
动漫世界	少儿
中国经营者	财经
射雕英雄传	武侠 古装
向幸福出发	现代都市 爱情 励志
何以笙箫默	现代都市 爱情
中国故事	历史传奇
昆仑决	体育
甄_传	古装 爱情
心理访谈	生活
优漫星未来	少儿艺术培训节目
加油小当家	真人秀
暴走吧队友	电子竞技
全球零距离	新闻
天天向上	 真人秀 脱口秀
中国梦想秀	 真人秀 内地
绿茵继承者	真人秀 综艺 少儿
等你爱我	现代都市
军迷淘天下	军事
私人订制	真人秀
夏洛特烦恼	 院线 青春 爱情
职来职往	真人秀
逃出生天	 救援 院线 动作
港_	 院线 剧情 犯罪
文化之旅	访谈
金星秀	访谈 脱口秀
喜羊羊与灰太狼	动漫 少儿
班淑传奇	古装 励志 爱情 历史传奇
大声说出来	情感 访谈
一站到底	综艺
财经郎眼	财经
社会纵横	新闻
神探狄仁杰	悬疑 历史传奇 古装 动作
陪你读书	综艺
俺娘田小草	乡村 家庭
我有传家宝	科教
幸福一家亲	喜剧
追鱼传奇	神话魔幻 古装 爱情
文化正午	新闻
商道	历史传奇 古装
神雕侠侣	武侠 古装 爱情
女医明妃传	古装 励志
古剑奇谭	武侠 古装 神话魔幻 爱情 动作
群英会	战争
食鉴出真知	综艺
寻宝	科教
走近中国消防	生活
巨神战击队	动作 动漫
寻找爱的冒险	爱情 现代都市 悬疑 青春偶像
泊客中国	科教
求爱大作战	真人秀 情感
西游降魔篇	喜剧 冒险 奇幻
闪亮的爸爸	真人秀 亲子 内地
减出我人生	生活
五鼠闹东京	小成本 政治 动作
东方新闻	新闻
梨园闯关我挂帅	戏曲
明星同乐会	综艺
中国音乐电视	音乐
华豫之门	科教
直播港澳台	新闻